height: 1
tiling: side
0110: 160
0011: 161
1001: 162
1100: 163
1111: 164